NO ./textures/wall_5_1.xpm
SO ./textures/wall_5_2.xpm
WE ./textures/wall_5_3.xpm

C 200,230,255
F       40,50,30

EA ./textures/wall_5_4.xpm

        1111111111
        10000000001
        10000000001
      11100000000011
      10000W000011
      111000000000111
        10000000001
        10000000001
        11111111111 