NO ./textures/wall_2_1.xpm
SO ./textures/wall_2_2.xpm
WE ./textures/wall_2_3.xpm
EA ./textures/wall_2_4.xpm

C 200,230,255
F 80,60,30

11111111111
10000000001
10000000001
10000000001
10000000N01
10000000001
10000000001
10000000001
11111111111
