NO ./textures/wall_4_1.xpm
SO ./textures/wall_4_2.xpm
WE ./textures/wall_4_3.xpm
EA ./textures/wall_4_4.xpm

C 200,230,255
F 80,60,30

111   111
111   111
111111111
  10001  
  10E01
  10001
111111111
111   111
111   111